05 05 05 05 05 05 05 05 05 05 05 05 05 05 05
05 01 01 01 01 01 01 01 01 01 01 01 01 01 05
05 01 01 01 01 01 01 01 01 01 01 01 01 01 05
05 01 01 01 01 01 01 01 01 01 01 01 01 01 05
05 01 01 01 01 01 01 01 01 01 01 01 01 01 05
05 01 01 01 01 01 01 01 01 01 01 01 01 01 05
05 01 01 01 01 01 01 01 01 01 01 01 01 01 05
05 01 01 01 01 01 01 01 01 01 01 01 01 01 05
05 01 01 01 01 01 01 01 01 01 01 01 01 01 05
05 01 01 01 01 01 01 01 01 01 01 01 01 01 05
05 01 01 01 01 01 01 01 01 01 01 01 01 01 05
05 01 01 01 01 01 01 01 01 01 01 01 01 01 05
05 01 01 01 01 01 01 01 01 01 01 01 01 01 05
05 01 01 01 01 01 01 01 01 01 01 01 01 01 05
05 05 05 05 05 05 01 01 01 05 05 05 05 05 05