05 05 05 05 05 05 00 00 00 05 05 05 05 05 05 05 05 05 05 05 05 05 05 05 05 05 05 05 05 05 05 05 05 05 05 05 05 05 05 05 05 05 05 05 05 05 05 05 05 05
05 01 00 01 01 01 01 01 00 01 01 01 01 01 01 00 01 01 00 01 01 00 01 01 00 01 01 01 00 01 01 01 01 01 01 01 01 00 01 01 01 01 01 01 00 01 01 01 01 05
05 01 01 00 01 00 01 01 01 01 01 01 01 01 01 01 01 01 01 01 01 00 01 01 00 00 01 01 01 01 01 00 00 00 00 01 01 01 01 00 00 01 00 01 01 01 01 00 01 05
05 01 00 01 01 01 01 01 01 01 01 00 01 00 01 01 01 01 01 01 01 00 00 01 01 01 01 01 01 01 01 01 00 00 01 01 01 01 00 01 01 01 01 01 01 01 01 01 01 05
05 01 01 01 00 00 00 01 01 01 01 01 01 01 01 01 01 01 01 00 01 01 00 01 01 01 01 01 01 00 01 01 01 00 00 01 01 01 01 01 01 01 01 01 01 01 01 00 01 05
05 00 01 01 00 01 01 00 01 00 01 01 01 01 01 01 01 01 01 01 01 00 00 00 01 01 01 01 01 01 00 01 01 01 00 01 01 01 00 01 00 01 01 01 01 01 00 01 00 05
05 01 01 01 01 00 01 01 00 01 00 01 01 00 01 01 01 01 01 01 01 01 01 01 00 01 01 01 01 01 01 01 00 01 01 01 01 01 00 01 00 01 01 01 00 01 00 01 01 05
05 01 01 01 01 01 01 01 01 01 00 01 01 01 01 01 01 01 01 01 01 01 01 01 01 01 00 01 00 01 01 00 01 00 01 01 01 01 00 00 01 01 00 01 00 00 01 00 01 05
05 01 01 01 01 00 01 01 01 01 00 01 01 01 01 00 01 01 01 01 01 01 01 01 01 01 01 00 01 00 01 01 01 01 01 01 01 01 01 01 01 01 01 01 00 00 01 01 01 05
05 00 01 01 01 01 00 01 01 01 01 01 01 01 01 01 01 01 01 01 01 00 01 01 00 01 00 01 01 00 00 01 01 01 00 00 00 01 01 01 01 01 01 01 00 01 01 01 01 05
05 01 01 00 00 00 01 00 01 01 01 01 00 00 01 01 01 01 00 01 01 01 01 01 01 01 01 01 01 01 01 01 01 01 00 00 00 01 01 01 01 01 01 01 01 00 01 01 00 05
05 01 01 00 01 01 01 01 00 01 01 01 01 01 01 01 01 01 01 00 00 01 01 01 01 01 01 01 01 01 01 01 00 01 00 01 01 01 01 01 01 01 01 01 01 01 01 01 01 05
05 01 01 00 00 01 01 01 01 01 00 00 00 01 00 01 00 00 00 00 01 01 00 01 01 01 01 00 01 01 01 01 01 00 00 01 01 01 01 01 01 01 01 01 01 00 01 01 01 05
05 01 00 01 01 01 01 01 01 01 01 00 01 01 01 01 01 01 00 00 01 01 01 01 01 01 00 01 01 01 01 01 01 01 01 01 01 00 01 01 01 01 01 01 01 00 01 01 01 05
05 01 01 01 01 01 00 01 01 01 01 01 01 00 01 01 01 01 01 00 01 01 01 01 01 01 01 01 01 00 01 01 01 00 00 01 01 01 00 01 00 00 00 01 01 00 01 01 01 05
05 01 01 00 00 01 00 01 01 01 01 01 01 01 01 00 01 00 01 01 01 01 01 01 00 01 01 01 01 01 00 01 00 00 01 00 01 00 01 01 01 01 01 00 01 01 01 01 01 05
05 01 01 01 01 01 01 01 00 01 01 01 01 01 01 01 01 01 01 01 01 01 01 01 00 01 00 01 01 01 01 01 01 01 01 01 01 01 01 00 01 00 01 00 01 01 01 01 01 05
05 00 00 01 01 01 00 01 01 01 01 01 01 01 00 00 00 01 00 01 01 01 01 01 01 01 01 00 01 01 01 01 00 01 00 01 01 01 01 01 01 01 00 01 01 01 00 00 00 05
05 01 01 00 00 01 01 01 01 01 01 00 01 01 01 00 00 01 01 01 01 01 01 01 01 01 01 01 01 01 01 01 01 01 01 01 01 01 01 01 01 01 01 01 01 01 00 01 01 05
05 01 01 01 00 01 01 01 01 01 01 01 01 01 01 01 01 01 01 00 01 01 00 01 01 01 01 01 00 01 01 01 01 01 01 00 01 01 00 01 01 01 01 01 01 01 01 01 01 05
05 01 01 00 01 00 00 01 00 01 00 01 01 01 01 01 01 01 00 01 00 01 01 01 01 01 00 01 00 01 01 00 01 00 01 01 00 01 01 01 01 01 01 00 01 00 01 00 01 05
05 01 00 01 01 01 01 01 01 01 00 00 00 01 00 01 00 01 01 01 01 01 00 01 01 01 01 01 01 01 01 01 01 01 01 01 01 01 01 01 01 00 01 01 01 01 01 01 01 05
05 01 00 01 01 01 01 01 01 01 01 01 00 01 01 01 01 00 01 01 01 01 01 01 01 01 00 01 01 01 01 01 01 01 00 01 01 01 01 00 01 01 01 01 01 01 01 00 01 05
05 01 00 01 01 01 01 01 01 01 01 00 00 01 00 01 01 01 01 00 01 00 01 01 00 00 01 01 01 01 01 01 01 00 01 01 01 01 00 01 01 01 01 01 01 00 00 01 01 05
05 01 00 01 01 01 01 01 01 00 01 00 01 00 00 01 00 01 01 05 05 05 05 05 05 05 05 05 05 00 01 01 01 01 01 00 01 01 01 01 00 01 01 01 01 01 01 01 01 05
05 01 01 01 01 00 01 01 00 01 01 01 00 01 01 01 01 00 01 05 10 10 10 10 10 10 10 10 05 01 01 01 01 00 00 01 01 00 01 01 00 01 01 01 01 01 01 01 01 05
05 01 01 01 01 01 01 01 00 01 01 00 01 00 01 01 00 01 01 05 10 10 10 10 10 10 10 10 05 01 00 01 00 01 01 01 01 00 01 00 01 00 00 01 01 01 01 01 01 05
05 01 00 00 00 01 00 01 01 01 00 01 01 01 01 01 01 00 01 05 10 10 05 05 05 05 10 10 05 01 01 01 01 01 01 01 01 01 01 01 01 01 01 01 01 00 01 00 00 05
05 00 01 01 01 01 01 01 00 01 01 01 01 01 00 00 01 00 01 05 10 10 05 06 07 05 10 10 05 01 01 01 01 01 01 01 01 01 01 01 01 01 00 01 01 01 01 00 01 05
05 00 01 01 01 01 01 00 01 01 01 01 01 00 00 01 00 00 01 05 10 10 05 08 09 05 10 10 05 01 01 01 01 01 01 00 01 01 01 00 01 01 01 00 01 01 01 01 01 05
05 01 01 01 00 01 01 01 01 01 01 01 01 01 01 01 01 01 01 05 10 10 05 05 05 05 10 10 05 01 01 01 00 01 01 01 01 01 01 01 01 01 01 01 01 01 01 01 01 05
05 00 01 00 00 01 01 01 01 00 01 00 01 00 00 01 01 01 01 05 10 10 10 10 10 10 10 10 05 01 01 01 01 01 00 00 01 01 01 01 00 01 01 01 01 01 01 01 01 05
05 01 01 01 01 01 01 01 01 01 01 00 00 01 01 01 00 00 01 05 10 10 10 10 10 10 10 10 05 01 01 01 01 01 01 01 01 01 01 01 00 01 00 01 00 00 01 01 01 05
05 01 01 00 01 01 01 01 00 00 01 01 01 01 01 00 01 00 01 05 05 05 05 05 05 05 05 05 05 01 00 01 01 01 01 01 01 01 00 01 01 01 01 01 01 01 01 01 01 05
05 01 01 01 01 01 00 01 01 01 01 01 01 01 01 01 01 01 01 01 01 01 01 01 01 01 01 01 00 00 00 01 01 01 01 01 01 00 01 01 01 01 01 01 01 00 01 01 01 05
05 01 01 01 00 00 01 01 01 01 01 00 01 00 01 01 00 00 01 01 01 01 00 00 01 00 01 01 01 01 01 00 01 01 00 01 01 00 01 01 00 01 01 01 01 01 01 01 00 05
05 00 01 01 01 01 01 01 00 01 00 01 00 01 01 00 00 01 01 00 00 01 01 01 01 01 01 01 01 01 01 01 01 00 01 01 00 01 01 01 01 01 01 01 01 00 01 01 01 05
05 01 01 01 01 01 01 01 01 01 01 01 01 01 01 01 01 01 00 01 00 01 01 00 01 01 01 01 01 01 01 01 01 01 01 01 01 01 01 01 00 01 00 01 01 00 00 01 01 05
05 01 01 01 00 01 01 01 01 01 01 00 01 01 01 01 00 01 01 01 01 00 01 01 00 01 01 00 01 00 01 01 01 01 01 01 01 01 01 01 01 01 01 01 01 01 01 01 00 05
05 01 01 01 00 01 00 01 01 01 01 01 01 01 01 00 01 01 01 01 00 01 01 01 01 01 01 01 00 01 01 01 01 01 01 01 01 00 01 01 01 01 01 01 00 01 01 01 01 05
05 01 01 01 01 01 01 01 01 01 01 00 00 01 00 01 01 01 01 01 00 01 00 01 00 01 01 00 01 01 00 01 01 01 01 01 01 01 01 01 01 01 01 01 01 01 01 01 01 05
05 01 01 01 01 01 01 01 00 01 01 00 00 01 01 00 01 01 01 00 01 01 01 01 01 00 01 01 01 00 01 01 01 01 00 01 01 01 01 01 00 00 00 01 00 01 01 00 01 05
05 01 01 01 01 01 00 01 01 01 00 01 01 00 01 01 01 01 01 01 00 00 00 01 01 01 01 01 01 00 01 01 01 01 01 01 01 01 01 01 01 01 01 01 01 00 01 01 01 05
05 00 01 01 01 01 01 01 01 01 01 00 00 01 01 01 01 01 00 01 01 01 01 01 01 01 00 01 01 01 00 01 01 00 01 01 01 01 01 00 01 01 01 01 01 01 01 01 01 05
05 01 00 01 01 01 01 01 01 01 01 01 01 01 01 01 00 01 00 01 01 00 01 00 01 01 01 01 01 01 00 01 01 01 01 01 01 01 01 01 01 01 00 01 01 01 01 01 01 05
05 01 01 01 00 01 01 00 01 01 01 01 01 01 01 00 01 00 01 00 00 01 01 01 01 01 01 01 01 01 01 01 01 01 01 00 01 01 01 01 01 01 01 01 01 01 00 01 01 05
05 00 01 01 01 01 01 01 00 01 01 01 01 01 01 01 01 00 00 01 01 01 01 01 01 01 01 01 01 00 01 00 01 01 01 00 01 01 01 01 01 01 01 00 00 01 01 01 01 05
05 00 01 01 01 01 00 01 01 01 01 00 01 00 01 01 01 01 01 01 01 01 01 01 00 01 01 00 01 01 00 01 01 01 01 00 01 00 01 00 01 01 01 01 01 01 01 00 01 05
05 00 01 01 01 00 00 01 01 01 00 00 01 01 01 01 01 01 01 01 01 01 00 01 01 01 01 01 01 00 01 01 01 01 00 00 01 01 01 01 01 01 01 01 01 01 01 01 01 05
05 05 05 05 05 05 05 05 05 05 05 05 05 05 05 05 05 05 05 05 05 05 05 05 05 05 05 05 05 05 05 05 05 05 05 05 05 05 05 05 05 05 05 05 05 05 05 05 05 05