11 09 07 04 06 11 02 11 11 04 11 11 11 11 11
11 11 11 09 04 04 11 12 14 11 11 11 11 11 09
11 09 07 04 06 11 11 15 17 11 11 11 09 04 04
11 07 04 06 11 11 11 15 17 11 07 04 06 11 11
11 09 07 04 06 11 02 15 17 04 11 11 11 11 11
11 09 07 04 06 11 02 15 17 04 11 11 11 11 11
11 11 11 09 04 04 11 15 17 11 11 11 11 11 09
11 09 07 04 06 11 11 15 17 11 11 11 09 04 04
11 07 04 06 11 11 11 15 17 11 07 04 06 11 11
11 09 07 04 06 11 02 15 17 04 11 11 11 11 11
11 11 11 09 04 04 11 15 17 11 11 11 11 11 09
11 09 07 04 06 11 11 15 17 11 11 11 09 04 04
11 07 04 06 11 11 11 15 17 11 07 04 06 11 11
11 09 07 04 06 11 02 15 17 04 11 11 11 11 11
11 11 11 09 04 04 11 12 14 11 11 11 11 11 09