05 05 05 05 05 05 05 05 05 05 05 05 05 05
05 11 11 11 11 11 11 11 11 11 11 11 11 05
05 11 11 11 11 11 11 11 11 11 11 11 11 05
05 11 11 11 11 11 11 11 11 11 11 11 11 05
05 11 11 11 11 11 11 11 11 11 11 11 11 05
05 11 11 11 11 11 11 11 11 11 11 11 11 05
05 11 11 11 11 11 11 11 11 11 11 11 11 05
05 11 11 11 11 11 11 11 11 11 11 11 11 05
05 11 11 11 11 11 11 11 11 11 11 11 11 05
05 11 11 11 11 11 11 11 11 11 11 11 11 05
05 11 11 11 11 11 11 11 11 11 11 11 11 05
05 11 11 11 11 11 11 11 11 11 11 11 11 05
05 11 11 11 11 11 11 11 11 11 11 11 11 05
05 11 11 11 11 11 11 11 11 11 11 11 11 05
05 05 05 05 05 05 00 00 00 05 05 05 05 05