05 05 05 05 05 05 00 00 00 05 05 05 05 05 05
05 00 00 00 00 00 00 00 00 00 00 00 00 00 05
05 00 00 00 00 00 00 00 00 00 00 00 00 00 05
05 00 00 00 00 00 00 00 00 00 00 00 00 00 05
05 00 00 00 00 00 00 00 00 00 00 00 00 00 05
05 00 00 00 00 00 00 00 00 00 00 00 00 00 05
05 00 00 00 00 00 00 00 00 00 00 00 00 00 05
05 00 00 00 00 00 00 00 00 00 00 00 00 00 05
05 00 00 00 00 00 00 00 00 00 00 00 00 00 05
05 00 00 00 00 00 00 00 00 00 00 00 00 00 05
05 00 00 00 00 00 00 00 00 00 00 00 00 00 05
05 00 00 00 00 00 00 00 00 00 00 00 00 00 05
05 00 00 00 00 00 00 00 00 00 00 00 00 00 05
05 00 00 00 00 00 00 00 00 00 00 00 00 00 05
05 05 05 05 05 05 05 05 05 05 05 05 05 05 05